3,8,0,11,12,8,12,-1
3,8,0,11,12,0,12,-1
3,8,0,11,12,11,12,-1
3,8,0,11,12,-1,12,-1
3,8,0,11,-1,-1,-1,-1
17,8,0,11,-1,-1,-1,-1
12,17,16,11,-1,-1,-1,-1
12,12,12,12,8,12,-1,-1
12,-1,-1,-1,-1,-1,-1,-1
12,-1,-1,-1,-1,-1,-1,-1
12,-1,-1,-1,-1,-1,-1,-1
