8,8,8,8,1,1,10,10
1,17,10,8,1,8,10,-1
1,17,16,10,8,8,8,-1
1,1,10,1,1,1,8,-1
11,11,11,1,5,5,-1,-1
11,11,1,10,5,1,-1,-1
11,11,1,10,10,1,1,-1
-1,-1,-1,-1,-1,-1,-1,-1
-1,-1,-1,-1,-1,-1,-1,-1
-1,-1,-1,-1,-1,-1,-1,-1
-1,-1,-1,-1,-1,-1,-1,-1
